NO ./textures/wall_north.xpm
SO ./textures/wall_south.xpm
WE ./textures/wall_west.xpm
EA ./textures/wall_east.xpm

F 0,50,10
C 0,100,44

        1111111111111111111111111
        1011000000110000100000001
        1111000001110001000000001
        100100000000000000W000001
111111111011000001110000100000001
100000000011000001110111111111111
1111011111111101110000001000011
11110111111111011101010010001
10000000000000001100000010001
10000000000000001101010010001
11000001110101011111011110001
11110111 1110101 101111010001
11111111 1111111 111111111111
