NO ./textures/wall_north.xpm
SO ./textures/wall_south.xpm
WE ./textures/wall_west.xpm
EA ./textures/wall_east.xpm

F 101,67,33
C 255,100,44

1111111111111111111111111
1111000000110000100000001
1111000001110001000000001
1111000000000000000000001
1111111110110000000100001
100000N000110000011101111
1111011111111101110000001
1111011111111101100101001
1000000000000000110000001
1000000000000000110101001
1100000111010101111101111
1111111111111111111111111
1111111111111111111111111
1111111111111111111111111
1111111111111111111111111
