NO ./textures/wall_north2.xpm
SO ./textures/wall_south2.xpm
WE ./textures/wall_west2.xpm
EA ./textures/wall_east2.xpm

F 101,67,33
C 255,100,44

1111111111111111111111111
1011000000110000100000001
1111000001110001000000001
10010000000000000W0000001
1111111110110000000100001
1000000000110000011101111
1111011111111101110000001
1111011111111101100101001
1000000000000000110000001
1000000000000000110101001
1100000111010101111101111
1111111111111111111111111
