NO ./textures/wall_north2.xpm
SO ./textures/wall_south2.xpm
WE ./textures/wall_west2.xpm
EA ./textures/wall_east2.xpm


F 101,67,33
C 255,100,44

11111111111111111111111111
10100000101000000000111111
10101010101111111000111111
10001010101000001000111
101110101011101011101
100000101010101000001
101111101011101111111
101000001010100000101
101011111010111110101
100000000S00000000001
101110101010101010101
100000101010001010001
101111101011111011101
100000101010100010001
101110101010101110111
101000101010100010101
101111111011111010101
100000001010001100001
10001011101111 1111101
10001000101001 100001
11111111111111 111111 
