NO ./textures/wall_north2.xpm
SO ./textures/wall_south2.xpm
WE ./textures/wall_west2.xpm
EA ./textures/wall_east2.xpm


F 101,67,33
C 255,100,44

        1111111111111111111111111
        1011000000110000100000001
        1111000001110001000000001
        1001000000000000000000001
111111111011000001110000100000001
100000000011000001110111111111111
1111011111111101110000001000011
11110111111111011101010010001
10000000000000001100W00010001
10000000000000001101010010001
11000001110101011111011110001
11110111 1110101 101111010001
11111111 1111111 111111111111
