NO ./textures/wall_north2.xpm
SO ./textures/wall_south2.xpm
WE ./textures/wall_west2.xpm
EA ./textures/wall_east2.xpm

F 101,67,33
C 255,100,44

111111111111111111111
101000001000000000001
101010101011111110001
100010100010000010001
101110101111101011101
100000101000101000001
101111101011101111111
101000001010100000101
101011111010111110101
101010001010100010101
101110101010101010101
100000101010001010001
101111101011111011101
100000101000100010001
101110101110101110111
101000100000100010101
101011111111111010101
110010000000000010001
100000111011111111101
1N1000001000000000001
111111111111111111111
