NO ./textures/wall_north2.xpm
SO ./textures/wall_south2.xpm
WE ./textures/wall_west2.xpm
EA ./textures/wall_east2.xpm


F 101,67,11
C 255,100,44

111111
100001
10N011
100001
100001
100001
100011
111111
