NO ./textures/wall_north2.xpm
SO ./textures/wall_south2.xpm
WE ./textures/wall_west2.xpm
EA ./textures/wall_east2.xpm


F 101,67,33
C 255,100,44

11111
10001
10N11
10001
10001
10001
10011
11111
